1111200021111111
0000000000000000
0040000000000000
0040000000000000
0000000000000000
0000000440000000
0000000000000000
0000000000000000
0000444000000000
0000000000000000
0000000000000000
0110000211100000
0110000111100000
0110000111100000
0000000000000000
1111111111111111